++++++++++++++++++++++++++++++++++++++++++++++++++++++++++++++++++++++++++++++++++++++++++++++++++++++++++++++++++++++++++
+                                                                                                                        +
+                                                                                                                        +
+++++++++++++++++++++       +++++++++++++++++++++++++++++++++++++         ++++++++++++++++++++++++++++++++++++++++++++++++
+                                                                                                                        +
+                                                                                                                        +
+++++++++++++++++++++++++++++++++++++++++++++++++++          +++++++++++++++++++++++++++++++           +++++++++++++++++++
+                                                                                                                        +
+                                                                                                                        +
++++++++++++          ++++++++++++++++++++++++++++++++++++++++++++++++++++++++++++++++++++++++++++++++++++++++         +++
+                                                                                                                        +
+                                                                                                                        +
++++++++++++++++++++++++++++++++++++++++++++              +++++++++++++++++++++++++++++++++++++++            +++++++++++++
+                                                                                                                        +
+                                                                                                                        +
+++++++++++++++++++++++++++++++++++++++++++++++++++++++++++         ++++++++++++++++++++++++++++++++++++++++++++++++++++++
+                                                                                                                        +
+                                                                                                                        +
+++++++++++++++++++++              +++++++++++++++++++++++++++++++++++++++++           +++++++++++++++++++++++++++++++++++
+                                                                                                                        +
+                                      p                                                                                  +
+++++++++++++++++++++++++++++++++++++++++++++++           ++++++++++++++++++++++++++++++++++++++++++++++++++++++++++++++++
+                                                                                                                        +
+                                                                                                                        +
+++++++++++++++++                +++++++++++++++++++++++++++++++++++++++++++++++++++++++++++++++++++++++++++++++++++++++++
+                                                                                                                        +
+                                                                                                                        +
++++++++++++++++++++++++++++++++++++++++++++++++++++++++++++++++++++++++++++++++++++++++++++++++++++++++++++++++++++++++++